### based on CMU Pronouncing Dictionary-0.7b http://www.speech.cs.cmu.edu/cgi-bin/cmudict
### incomplete entries added by hand 28.02.2021
(air)plane	EH
(pussy)cat	P
(tomato) sauce	T
Bath (tub)	B
Bathroom	B
TV	T
all gone	AO
animal	AE
ankle	AE
ant	AE
apple	AE
arm	AA
asleep	AH
aunt	AE
awake	AH
baa baa	B
baby	B
babysitter	B
backyard	B
bad	B
ball	B
balloon	B
banana	B
barbecue	B
basket	B
bat	B
bath	B
beach	B
beanie	B
beans	B
bear	B
bed	B
bedroom	B
bee	B
bellybutton/navel	B
belt	B
bench	B
better	B
bib	B
bicycle/bike	B
big	B
bin	B
bird	B
biscuit/bickie	B
bite	B
black	B
blanket	B
block/brick	B
blow	B
blue	B
boat	B
book	B
boot(s)	B
bottle	B
bottom	B
bowl	B
box	B
boy	B
bread	B
break	B
breakfast	B
breasts	B
bring	B
broken	B
broom	B
brother	B
brown	B
brush	B
bubbles	B
bucket	B
bug	B
build	B
bump	B
bunny/rabbit	B
bus	B
bush	B
butter	B
butterfly	B
button	B
buy	B
cake	K
call	K
call(phone)	K
camera	K
can	K
car	K
careful	K
carrot	K
carry	K
catch	K
cereal	S
chair	CH
chase	CH
cheek	CH
cheese	CH
chewing gum/chewie	CH
chicken	CH
child/kid	CH
childs own name	CH
chin	CH
chocolate	CH
choo choo	CH
church/mosque	CH
city	S
clap	K
clean	K
climb	K
clock	K
close	K
cloud	K
clown	K
coat	K
cockadoodledoo	K
cockroach	K
coffee	K
coke	K
cold	K
comb	K
computer	K
cook	K
cordial	K
corn	K
cot	K
couch/lounge/sofa	K
country	K
cover	K
cow	K
cowboy	K
crayon	K
crib	K
crocodile	K
cry	K
cuddle	K
cup	K
custard	K
cut	K
cute	K
daddy	D
dance	D
dark	D
deer	D
dinner	D
dirty	D
dish	D
doctor	D
dog	D
doll	D
donkey	D
door	D
doughnut	D
draw	D
drawer	D
dress	D
drink	D
drive	D
drop	D
dry	D
duck	D
dump	D
ear	IY
easy	IY
eat	IY
egg	EH
elephant	EH
empty	EH
eye	AY
face	F
fall	F
farm	F
fast	F
feed	F
find	F
fine	F
finger(s)	F
finish	F
fire truck/engine	F
fireman	F
first	F
fish	F
fit	F
fix	F
flag	F
flower	F
food	F
foot/feet	F
footpath	F
fork	F
fridge	F
friend	F
friends name	F
frog	F
full	F
game	G
garage	G
garbage/rubbish	G
garden	G
gentle	JH
get	G
giraffe	JH
girl	G
give	G
give me five!	G
glass	G
glue	G
go	G
go potty	G
good	G
goodbye/bye bye	G
goose	G
grandma/nanna	G
grandpa/pop	G
grapes	G
grass	G
green	G
grr	G
hair	HH
hamburger	HH
hammer	HH
hand	HH
happy	HH
hard	HH
hat	HH
hate	HH
have	HH
head	HH
hear	HH
heavy	HH
helicopter	HH
hello	HH
help	HH
hi	HH
hide	HH
hide and seek/hidie	HH
high	HH
high chair	HH
hit	HH
hold	HH
home/house	HH
horse	HH
hose	HH
hot	HH
hug	HH
hungry	HH
hurry	HH
hurt	HH
ice	AY
ice cream	AY
jacket	JH
jam	JH
jar	JH
jeans	JH
jelly	JH
juice	JH
jump	JH
jumper	JH
kangaroo/roo	K
keys	K
kick	K
kiss	K
kitchen	K
knee	N
knife	N
knock	N
know	N
koala	K
ladder	L
lady	L
lamb	L
lamp	L
last	L
lawn mower	L
leg	L
lick	L
light	L
like	L
lion	L
lips	L
listen	L
little	L
living/lounge room	L
lolly	L
long	L
look	L
loud	L
love	L
lunch	L
mad	M
make	M
man	M
mango	M
meat	M
medicine	M
meow	M
milk	M
money	M
monkey	M
moo	M
moon	M
mop	M
motorbike	M
mouse	M
mouth	M
movies	M
muffin	M
mug	M
mummy	M
nail(s)	N
nap	N
nappy	N
nasty	N
naughty	N
neck	N
necklace	N
new	N
newspaper/paper	N
nice	N
night night	N
no/dont	N
noisy	N
noodles	N
nose	N
nurse	N
nuts	N
old	OW
open	OW
orange	AO
ouch	AW
outside	AW
oven/stove	AH
owl	AW
paint	P
pancake	P
pants	P
park	P
party	P
pasta	P
patty cake/pat-a-cake	P
peanut butter	P
peas	P
peekaboo	P
pen	P
penguin	P
people	P
person	P
petrol station	P
pets name	P
photo	F
pick	P
picnic	P
picture	P
pig	P
pillow	P
pineapple	P
pizza	P
plant	P
plate	P
play	P
play dough	P
play pen	P
playground	P
please	P
police(man)	P
pony	P
pool	P
poor	P
popcorn	P
possum	P
postman	P
potato	P
potato chip/crisps	P
potty	P
pour	P
pram	P
present/pressie	P
pretend	P
pretty	P
pudding	P
pull	P
pumpkin	P
puppy	P
purse/wallet	P
push	P
put	P
puzzle	P
pyjamas/jamies	P
quack quack	K
quiet	K
radio	R
rain	R
raisin	R
read	R
red	R
ride	R
rip	R
rock	R
rocking chair	R
roof	R
room	R
run	R
sad	S
salt	S
sandpit	S
sandwich	S
say	S
scared	S
school/kindie/preschool	S
scissors	S
scratch	S
see	S
serviette/napkin	S
shake	SH
share	SH
shed	SH
sheep	SH
shh/shush/hush	SH
shirt	SH
shoe(s)	SH
shop	SH
shopping	SH
shorts	SH
shoulder	SH
shovel	SH
show	SH
shower	SH
shut	SH
sick	S
sing	S
sink	S
sister	S
sit	S
sky	S
sleep	S
sleepy	S
slide	S
slipper(s)	S
slow	S
smell	S
smile	S
snack	S
snake	S
soap	S
sock(s)	S
soft	S
soup	S
spaghetti	S
spider	S
spill	S
splash	S
spoon	S
sprinkler	S
stairs	S
stand	S
star	S
stay	S
stick	S
sticky	S
stomach/tummy	S
stone	S
stop	S
story	S
strawberry	S
street	S
stroller	S
stuck	S
sun	S
sunglasses/sunnies	S
sweep	S
swim	S
swing	S
table	T
take	T
talk	T
tape	T
taste	T
teacher	T
tear	T
teddy bear	T
telephone/phone	T
tell	T
thank you	TH
think	TH
thirsty	TH
thongs	TH
three wheeler/tricycle	TH
throw	TH
tickle	T
tiger	T
tiny	T
tired	T
tissue	T
toast	T
toe(s)	T
tongue	T
tooth/teeth	T
toothbrush	T
touch	T
towel	T
toy	T
tractor	T
train	T
tray	T
tree	T
truck	T
tuna	T
turkey	T
turtle	T
uh oh	AH
uncle	AH
underpants/undies	AH
vacuum cleaner	V
vanilla	V
vegemite	V
veranda/porch	V
vitamins	V
vroom/broom	V
wait	W
wake	W
walk	W
wall	W
want to	W
wardrobe	W
wash	W
washing machine	W
watch	W
water	W
waves	W
wet	W
white	W
wind	W
window	W
windy	W
wipe	W
wish	W
wombat	W
woof woof	W
work	W
write	R
yard	Y
yellow	Y
yes	Y
yoghurt	Y
yucky	Y
yum yum	Y
yummy	Y
zebra	Z
zipper	Z
zoo	Z
