### based on Santiago Spanish Lexicon https://www.openslr.org/34/ apache 2.0 license
### incomplete entries added by hand 28.02.2021
a	a
a ver...	a
abajo	a
abeja	a
abrigo	a
abrir	a
abuela	a
abuelo	a
acabar	a
acerrín	a
acompañar	a
acostar(se)	a
adentro	a
adíos/byebye	a
afuera	a
agarrar	a
agua	a
ahorita/ahora	a
ahí	a
ahí te voy	a
al agua patos...	a
al rato	a
alberca/piscina	a
allá	a
allí	a
almohada	a
almorzar	a
alto	a
amarillo	a
amarrar(se)	a
amiga	a
amigo	a
andar	a
animal	a
antes	a
apagar	a
apurar(se)	a
aquel	a
aquella	a
aquellas	a
aquellos	a
aquí	a
araña	a
ardilla	a
aretes	a
arreglar(se)	a
arriba	a
arroz	a
aspiradora	a
asustar(se)	a
así	a
atole	a
atrás	a
atún	a
autobús	a
aventar	a
avión	a
ayer	a
ayudar	a
azul	a
azúcar	a
babero	b
bacinica	b
bailar	b
bajar(se)	b
banco (outside)	b
banco (places)	b
bandera	b
barba	b
barco	b
barrer	b
basura	b
bat	b
baño	b
bebé	b
bee/mee	b
besar	b
besitos	b
bicho	b
bicicleta	b
bien	b
bigote	b
blanco	b
boca	b
bolsa (clothing)	b
bolsa (household)	b
bonita	b
borrego	b
bosque	b
botas	b
botella/mamila	b
botón	b
bravo	b
brazo	b
brincar	b
buenas noches	b
bueno	b
buenos días	b
buey	b
bufanda	b
burbujas	b
burro	b
buscar	b
búho	b
caballo	k
caber	k
cabeza	k
cacahuete/maní	c
cachete	k
caer(se)	k
café	k
caja	k
cajón	k
calabaza	k
calcetín	k
caliente	k
callar(se)	k
calle	k
calzón	k
cama	k
caminar	k
camisa	k
camión de bombero	k
camión/troca	k
campo	k
canasta	k
cansado	k
cantar	k
cara	k
cargar	k
carne	k
carreola	c
carro/coche	k
casa	k
cassette	c
cebra	s
cenar	s
cepillo	s
cepillo de dientes	s
cerca	s
cereal	s
cerillos	s
cerrar	s
cerro	s
champú	ʧ
chancla	ʧ
chaparro	ʧ
chichi/pecho	ʧ
chicle	ʧ
chico	ʧ
chile	ʧ
chocolate	ʧ
chulo	ʧ
chupón/chupete	ʧ
chícharo	ʧ
cielo	s
cierre	s
cigarros	s
cine	s
circo	s
clavo	k
cobija	k
cochera/garage	k
cocina	k
cocinar	k
cocodrilo	k
coladera	k
collar	k
colores	k
columpio	k
comer(se)	k
comida	k
comprar	k
computadora	k
con	k
conejo	k
correr	k
cortar	k
cosquillitas	k
crayolas	k
cuacuá	k
cuadro	k
cuarto	k
cubeta	k
cuchara	k
cuchillo	k
cuna	k
cura	k
cuál	k
cuándo	k
cámara	k
cómo	k
dar	d
de	d
decir	d
dedo	d
desayunar	d
descompuesto	d
despacio	d
despierto	d
después	d
dibujar	d
dientes	d
diferente	d
difícil	d
dinero	d
doctor	d
doler	d
dormir(se)	d
dulce	d
durazno	d
duro	d
día	d
dónde	d
ejotes	ɛ
el (propositions)	ɛ
elefante	ɛ
ella	ɛ
ellas	ɛ
ellos	ɛ
elote	ɛ
empujar	ɛ
en	ɛ
en la mañana	ɛ
en la noche	ɛ
en la tarde	ɛ
encima	ɛ
encontrar	ɛ
enfermera	ɛ
enfermo	ɛ
enfrente	ɛ
enojado	ɛ
enseñar	ɛ
entonces	ɛ
entrar	ɛ
entre	ɛ
equivocar(se)	ɛ
esa	ɛ
esas	ɛ
escaleras	ɛ
escoba	ɛ
esconder(se)	ɛ
escribir	ɛ
escuchar	ɛ
escuela	ɛ
ese	ɛ
eso	ɛ
esos	ɛ
espagueti	ɛ
espejo	ɛ
esperar(se)	ɛ
estar	ɛ
esto	ɛ
estrella	ɛ
estufa	ɛ
falda	f
familia	f
feliz	f
feo	f
fiesta	f
flaco	f
flor	f
foca	f
fotos	f
fresa	f
frijoles	f
frío	f
fuchi	f
fuego	f
fuerte	f
fábrica	f
galleta	g
gallina	g
ganar	g
ganso	g
garganta/anginas	g
gato	g
gelatina	x
globo/bomba	g
gordo	g
gorra	g
gracias	g
grande	g
gritar	g
guaguá	g
guajolote	g
guantes	g
guapo	g
gustar	g
haber (hay)	a
hacer	a
hambre	a
hamburguesa	a
helado/nieve	ɛ
helicóptero	ɛ
hermana	ɛ
hermano	ɛ
hielo	i
hipopótamo	i
hoja/papel	o
hojas	o
hola	o
hombro	o
hormiga	o
horno	o
hospital/clínica	o
hot cakes	o
hoy	o
huevo	w
iglesia/templo	i
igual	i
ir(se)	i
jabón	x
jalar	x
jamón	x
jardín	x
jirafa	x
jugar	x
jugo	x
juguete	x
juntar	x
la	l
labios	l
largo	l
las	l
lastimar(se)	l
lavabo	l
lavadora	l
lavar(se)	l
le	l
leche	l
leer	l
lejos	l
lengua	l
lentes	l
lento	l
les	l
levantar(se)	l
leña	l
león	l
librero	l
libro	l
licuado	l
limonada	l
limpio	l
linda	l
llave	ʎ
lleno	ʎ
llevar(se)	ʎ
llorar	ʎ
llover	ʎ
lluvia	ʎ
lo	l
lobo	l
los	l
luego	l
luna	l
luz	l
lámpara	l
lápiz	l
maceta	m
madrina	m
maestra	m
mal	m
malo	m
mamá	m
manguera	m
mano	m
manos arriba	m
mantequilla	m
manzana	m
mariposa	m
martillo	m
mañana	m
me	m
medias	m
medicina	m
mejor	m
melón	m
mermelada	m
mesa	m
meter(se)	m
miau	m
miedo/susto	m
mirar	m
mojado	m
mono	m
morado	m
morder	m
mosca	m
mosco	m
moto	m
mucho	m
mueble	m
muu	m
muñeca	m
muñeco de nieve	m
más	m
mí	m
mía	m
mías	m
mío	m
míos	m
nada	n
nadar	n
nalgas	n
nana	n
naranja	n
nariz	n
negro	n
nieve	n
niña	n
niño	n
no	n
no hay	n
noche	n
(nombre del niño/a)	n
nosotros	n
nube	n
nuestro	n
nuevo	n
o	o
oficina	o
ojitos	o
ojos	o
okay	o
olla	o
ombligo	o
oreja	o
oscuro	o
osito	o
oso	o
otro/otra vez	o
oír	o
padrino	p
pala	p
paleta	p
palo	p
palomitas	p
pan	p
pan dulce	p
pantalón	p
panza	p
papas	p
papel	p
papitas	p
papá	p
para	p
parar(se)	p
parque	p
pasas	p
pasta de dientes	p
pastel	p
pasto	p
patear	p
patinar	p
patines	p
patio (outside)	p
patio (places)	p
pato	p
payaso	p
pañal	p
pañuelo	p
peanut butter	p
pegajoso	p
pegar(se)	p
peinar(se)	p
peine	p
peligroso	p
pelo	p
pelota	p
pene	p
pensar	p
perder	p
periódico	p
pero	p
perro	p
persona	p
pesado	p
pescado	p
pescado (food_drink)	p
piedra	p
piernas	p
pies	p
pijama	p
pingüino	p
pintar	p
pinturas	p
pipí	p
plancha	p
planta	p
plastilina	p
platicar	p
plato	p
playa	p
playera	p
pluma/plumones	p
plátano/banana	p
pobre	p
poco/poquito	p
poder	p
policía	p
pollito	p
pollo	p
pon pon tata	p
poner(se)	p
por favor	p
por qué	p
prender	p
prima	p
primero	p
primo	p
puerco	p
puerta	p
pues	p
pájaro	p
pío pío	p
que (connection word)	k
quedar(se)	k
quemar(se)	k
querer	k
quesadilla	k
queso	k
quiquiriquí	k
quitar(se)	k
quién	k
qué (question_words)	k
radio	ɾ
rana	ɾ
rancho	ɾ
ratón	ɾ
recámara	ɾ
refrigerador	ɾ
regadera/ducha	ɾ
regalar	ɾ
reja	ɾ
reloj	ɾ
resbaladilla	ɾ
rodilla	ɾ
rojo	ɾ
romper	ɾ
ropa	ɾ
ropero/closet	ɾ
rosa	ɾ
roto	ɾ
ruidoso	ɾ
rápido (descriptive)	ɾ
rápido (quantifiers)	ɾ
río	ɾ
saber	s
sacar	s
sal	s
sala	s
salchicha	s
salir(se)	s
salsa	s
saltar	s
salud	s
saludar	s
sandía	s
se	s
secadora	s
seco	s
sentar(se)	s
ser	s
servilleta	s
señor	s
señora	s
shhh	ʃ
shorts	ʃ
siesta	s
silla	s
sillón	s
soda/refresco	s
sofá	s
sol	s
sombrero	s
sopa	s
soplar	s
su	s
suave	s
subir(se)	s
sucio	s
suya	s
suyas	s
suyo	s
suyos	s
suéter	s
sí	s
taco	t
tambor	t
tanque	t
tapar	t
tapete	t
taza	t
te (pronouns)	t
te voy a pegar...	t
techo	t
televisión	t
teléfono	t
tenedor	t
tener	t
tengo manita	t
terminar	t
tienda/mercado	t
tierra	t
tigre	t
tijeras	t
timbre	t
tina	t
tirar	t
toalla	t
tocar	t
todo	t
tomar(se)	t
tonto	t
torta/lonche	t
tortilla	t
tortillitas	t
tortuga	t
tractor	t
traer(se)	t
tranquilo	t
trapo	t
travieso	t
tren	t
triciclo (toys)	t
triciclo (vehicles)	t
trineo	t
triste	t
tutú	t
tuya	t
tuyas	t
tuyo	t
tuyos	t
té (food)	t
tí	t
tía	t
tío	t
tú	t
un	u
una	u
unas	u
uno dos tres...	u
unos	u
uvas	u
vaca	b
vacío	b
vagina	b
vainilla	b
vasos	b
vela	b
venado	b
venir(se)	b
ventana	b
ver(se)	b
verde	b
vestido	b
viejo	b
viento/aire	b
vitaminas	b
vámonos	b
víbora	b
y	i
ya	j
yo	j
yoghurt	j
zanahoria	s
zapato	s
zoológico	s
¡am!	a
¡ay!	a
¡pum!	p
árbol	a
él (pronouns)	ɛ
ésta	ɛ
éstas	ɛ
éste	ɛ
éstos	ɛ
último	u
