### based on g2p-no NoFAbet edition (https://github.com/peresolb/g2p-no) of NST lexicon (https://www.nb.no/sprakbanken/en/resource-catalogue/oai-nb-no-sbr-23/)
### incomplete entries added by hand 28.02.2021
(brød)skive	B
(leke)bamse	B
(meite)mark	M
Borte! (lek hvor ansikt gjemmes og plutselig vises)	B
PC	P
TV	T
agurk	AH
akebrett	AA
alle	AH
alt	AH
and	AH
andre	AH
ankel	AH
ansikt	AH
apekatt	AA
appelsin	AH
arm	AH
at	AH
au	AEW
av	AH
baby	B
bad	B
bade	B
badebasseng	B
badekar	B
bak	B
bakgård	B
balkong	B
ball	B
ballong	B
banan	B
barn	B
barneseng	B
barnestol	B
barnets navn	B
barnevaktens navn	B
barnevogn	B
bedre	B
bein	B
belte	B
bensinstasjon	B
bestefar	B
bestemor	B
bil	B
bilde	B
bite	B
bjørn	B
bleie	B
bli	B
blomst	B
blyant	B
blå	B
blåse	B
bløt	B
bok	B
boks	B
boller	B
bonde	B
bondegård	B
bord	B
bort	B
borte	B
bra	B
brannbil	B
brannmann	B
brett	B
briller	B
bror	B
brrr (bil-lyd)	B
brun	B
brus	B
bråke	B
bråkete	B
brød	B
bukse	B
burde	B
buss	B
butikk	B
byen	B
bygge	B
båt	B
bære	B
bææ	B
bønner	B
bør	B
børste	B
bøtte	B
campingplass	K
cola	K
corn flakes	K
cowboy	K
dag	D
dame	D
danse	D
de	D
deg	D
deg selv	D
dele	D
dem	D
den	D
denne	D
der	D
dere	D
deres	D
dessert	D
det	D
dette	D
din	D
disse	D
do	D
doktor	D
dopapir	D
dra	D
dress (ute)	D
drikke (action)	D
drikke (beverage)	D
druer	D
du	D
dukke	D
dusj	D
dyne	D
dyr	D
dyrehage	D
dytte	D
dårlig	D
dør	D
egg	EH
ei	AEJ
ekkelt	EH
ekorn	EH
elefant	EH
elg	EH
eller	EH
elske	EH
en	EE
en annen	EE
eple	EH
er	EE
erter	AEH
esel	EE
eske	EH
et	EE
etter	EH
ettermiddag	EH
etterpå	EH
eventyr	EE
falle	F
fange	F
farfar	F
fargeblyant	F
farmor	F
fat	F
fest	F
fin	F
finger	F
finne	F
fisk (animal)	F
fisk (food)	F
fjell	F
flagg	F
flaske	F
flue	F
fly	F
folk	F
for	F
foran	F
fordi	F
formiddag	F
forsiktig	F
fort	F
fortau	F
forte seg	F
fot	F
fra	F
frekk	F
frem	F
frokost	F
frokostblanding	F
frosk	F
frukt	F
fugl	F
full	F
få	F
følge etter	F
før	F
først	F
gaffel	G
gakk gakk	G
gammel	G
garasje	G
genser	G
gi	J
gjemme	J
gjennom	J
gjorde	J
gjør	J
gjøre	J
gjøre seg ferdig	J
glad	G
glass	G
gli	G
glidelås	G
god	G
god natt	G
godteri	G
gress	G
gressklipper	G
gris	G
grr	G
gråte	G
grønn	G
grøt	G
gul	G
gulrot	G
gutt	G
gyngestol	J
gå	G
gå på do	G
gåbil	G
gås	G
ha	H
ha det	H
hadde	H
hage	H
hake	H
hallo	H
halskjede	H
ham	H
hamburger	H
hammer	H
han	H
handle	H
hane	H
hans	H
hansker	H
har	H
hard	H
hate	H
hei	H
helikopter	H
helle	H
helsesøster	H
henne	H
hennes	H
hente	H
her	H
hest	H
himmel	H
hit	H
hjelpe	J
hjem	J
hjemme	J
hode	H
holde	H
holde øye med	H
hoppe	H
hos	H
hun	H
hund	H
hus	H
huske (action)	H
huske (object)	H
hva	V
hvem	V
hver	V
hverandre	V
hvert	V
hvilken	V
hvis	V
hvit	V
hvor	V
hvordan	V
hvorfor	V
hysj	H
hånd	H
håndkle	H
hår	H
høne	H
høre	H
høre etter	H
høy	H
i	IH
i dag	IH
i går	IH
i kveld	IH
i morgen	IH
i stedet for	IH
ikke (amount)	IH
ikke (routine)	IH
ingen	IH
ingenting	IH
inn	IH
inne	IH
inni	IH
is	II
ja	J
jakke	J
jeg	J
jente	J
jo	J
jobb	J
jobbe	J
joggesko	J
jordbær	J
juice	J
kaffe	K
kake	K
kald	K
kam	K
kamera	K
kan	K
kanin	K
kasse	K
kaste	K
katt	K
kattunge	K
kile	KJ
kinn	K
kino	KJ
kirke	KJ
kjeks	KJ
kjelke	KJ
kjeller	KJ
kjole	KJ
kjøkken	KJ
kjøkkenrull	KJ
kjøleskap	KJ
kjøpe	KJ
kjøre	KJ
kjøtt	KJ
kjøttkaker	KJ
klappe	K
klappe kake	K
klatre	K
kle på	K
klemme	K
klissete	K
klokke	K
klosser	K
klovn	K
knapper	K
kne	K
knekkebrød	K
kniv	K
komfyr	K
kopp	K
kost	K
koste	K
kritt	K
krokodille	K
krukke	K
krus	K
ku	K
kunne	K
kveld	K
kveldsmat	K
kykeliky	K
kylling (animal)	KJ
kylling (food)	KJ
kysse	KJ
la	L
lage mat	L
lam	L
lampe	L
landet	L
lang	L
lastebil	L
late som	L
legge	L
lego	L
lei seg	L
leke (action)	L
leke (object)	L
lekegrind	L
lekeplass	L
lepper	L
lese	L
leverpostei	L
like	L
lim	L
liten	L
litt	L
lommebok	L
lue	L
lukke	L
lunsj	L
lys	L
lærer	L
løpe	L
løve	L
mage	M
male	M
mamma/mor	M
man	M
mange	M
mann	M
mat	M
mate	M
matpakke	M
maur	M
med	M
medisin	M
meg	M
meg selv	M
melk	M
melon	M
men	M
mennesker	M
mer	EH
middag	M
min	M
miste	M
mjau	M
morfar	M
morgen	M
mormor	M
mot	M
motorsykkel	M
munn	M
mus	M
mye	M
mygg	M
må	M
måne	M
måtte	M
mørkt	M
møø	M
nam - nam	N
natt	N
navle	N
navn på kjæledyr	N
ned	N
nede	N
nedi	N
nei	N
nese	N
noe	N
noen	N
nugatti	N
ny	N
nå	N
når	N
nøkler	N
nøtter	N
og	OA
også	OAH
oi (uttrykk for overraskelse)	OJ
oldefar	OAH
oldemor	OAH
om	OO
onkel	OH
opp	OAH
oppe	OAH
oppi	OAH
oppå	OAH
oransje	OH
oss	OAH
ost	OH
over	OA
ovn	OAH
pannekake	P
papir	P
pappa/far	P
park	P
passe	P
pasta	P
pen	P
penger	P
penn	P
pingvin	P
pinne	P
pizza	P
plante	P
plaske	P
plastilina	P
politi	P
pommes frites	P
ponni	P
popcorn	P
postbud	P
poteter	P
potetgull	P
potte	P
presang	P
prøve	P
pupp	P
puslespill	P
puste	P
pute	P
putte	P
pysjamas	P
på	P
pølser	P
radio	R
rar	R
redd	R
regn	R
regntøy	R
reinsdyr	R
ren	R
reparere	R
ri	R
ringe	R
ris	R
riste	R
ristet brød	R
rive av	R
rom	R
rosiner	R
rumpe	R
rydde	R
rygg	R
rød	R
røre	R
saft	S
saks	S
salami	S
salt	S
samme	S
sandaler	S
sandkasse	S
sau	S
saus	S
se	S
se på	S
sebra	S
seg	S
seg selv	S
sekk	S
sen	S
senere	S
seng	S
serviett	S
sette	S
shorts	SJ
si	S
sin	S
sint	S
sirkus	S
sist	S
sitte	S
sitter fast	S
sjiraff	SJ
sjokolade	SJ
skal	S
skap	S
skilpadde	SJ
skitten	SJ
skje	SJ
skjerf	SJ
skjorte	SJ
skjære	SJ
skjønn	SJ
skli	S
sklie	S
sko	S
skogen	S
skole	S
skrive	S
skuff	S
skulder	S
skulle	S
skyer	SJ
skynde seg	SJ
skål	S
slem	SJ
slikke	SJ
slutte	SJ
slå	SJ
slå seg	SJ
smake	S
smekke	S
smile	S
smokk	S
smør	S
snakke	S
snill	S
snurre rundt	S
snø	S
snømann	S
sofa	S
sokker	S
sol	S
som	S
sommerfugl	S
sove	S
soverom	S
sovetid	S
spade	S
spagetti	S
sparke	S
spill	S
spille	S
spise	S
stakkars	S
steiner	S
stige	S
stikke	S
stille	S
stjerner	S
stol	S
stoppe	S
stor	S
strand	S
strømpebukse	S
strømper	S
stue	S
stå	S
støvler	S
støvsuger	S
sukkertøy	S
sulten	S
suppe	S
sur	S
svart	S
svømme	S
svømmehall	S
syk	S
sykkel	S
syltetøy	S
synge	S
så	S
såpe	S
såpebobler	S
sååå stor	S
søle	S
søppel	S
søppelbøtte	S
søster	S
søt	S
søvnig	S
t-skjorte	T
ta	T
tak	T
takk	T
tallerken	T
tannbørste	T
tante	T
te	T
tegne	T
telefon	T
tenke	T
tenner	T
teppe	T
terrasse	T
tid	T
tiger	T
til	T
tilbake	T
tiss	T
tog	T
tom	T
traktor	T
trampoline	T
tran	T
trapp	T
tre	T
treffe	T
trehjulssykkel	T
trøtt	T
tung	T
tunge	T
tyggegummi	T
tå	T
tøff-tøff	T
tøfler	T
tørke	T
tørketrommel	T
tørr	T
tørst	T
ugle	UH
ulv	UH
under	UH
underbukse	UH
ut	UU
ute (location)	OH
utenfor	UU
utenpå	UU
vafler	V
valp	V
vann (beverage)	V
vann (not beverage)	V
vannslange	V
var	V
varm	V
vask	V
vaske	V
vaskemaskin	V
ved siden av	V
vei	V
vekk	V
velte	V
venn	V
venninne	V
vent	V
vente	V
veps	V
veske	V
vi	V
vil	V
ville	V
vind	V
vindu	V
vise	V
voff voff	V
vondt	V
votter	V
våken	V
våkne	V
vår	V
våt	V
vær så snill	V
være	V
være glad i	V
yoghurt	J
åpne	OA
ødelagt	OE
ødelegge	OE
ønske	OEH
øre	OE
øye	OEJ
”kommer og tar deg” lek	K
